+-+-+-+-+-+-+-+-+-+-+-+-+-+-+-+-+-+-+-+-+
|               |  *|     |             |
+ +-+-+-+ +-+-+ + + + +-+-+ +-+-+-+-+-+ +
|     |   |   |   |   |     |         | |
+-+ +-+ + + + +-+-+-+-+ +-+ + +-+-+-+ + +
|   |   |   |           |   | |   |   | |
+ + + +-+-+-+-+-+-+-+-+-+ +-+ +-+ + +-+ +
| | | |       |   |   |   | |   | | |   |
+ + + +-+-+-+ +-+ + + + + + +-+ + + +-+ +
| | |   |         | | | |   |   |   |   |
+ +-+-+ + +-+-+ +-+-+ +-+-+-+ +-+-+ + +-+
|     | |   |   | |   |           |     |
+-+-+ + +-+ +-+-+ + + + +-+ +-+-+-+-+-+ +
|     |   |   |   | | |   |   |       | |
+ +-+ +-+ +-+ + + + +-+-+ +-+ + +-+-+-+ +
| |   |   |   | |   |   |   |   |     | |
+ +-+-+ +-+ + + +-+-+ + +-+ +-+-+ +-+ + +
| |   |     |   |   | |   | |   | |   | |
+ + + +-+ +-+-+ + + + +-+ + + + + + +-+ +
| | |   |   |   | |     | | | |   | |   |
+ + +-+ +-+ + +-+-+-+ +-+ + + +-+-+ +-+-+
| |   | |   |     |   |   |   |     |   |
+ +-+-+ + +-+-+-+ +-+-+ + +-+ +-+-+-+ + +
|   |   |   |   |   |   | |     |     | |
+-+ + +-+-+ + + +-+ + +-+ + +-+ + +-+-+ +
| | |   | | | |   |   | | | | | | |     |
+ + +-+ + + + +-+-+-+-+ + + + + + + +-+-+
|   |   |   |     |       |   |   |     |
+-+ + +-+ +-+ +-+ + +-+-+-+ +-+-+-+-+-+ +
| | |   | |   |   |   |   |     |     | |
+ + + +-+ + +-+-+-+ + + + +-+-+-+ +-+ + +
| |   |   | |       |   |   |     |     |
+ +-+-+ + + +-+ + +-+-+-+-+ + +-+-+ +-+-+
|       | |   | | |       | |     |   | |
+-+ +-+-+-+-+ + +-+ +-+-+ + +-+ +-+-+ + +
| | |   |     |   |     | | | |     | | |
+ + + +-+ +-+ + + +-+-+ + + + +-+-+ + + +
| | |     |   | |     | | |   |     |   |
+ + +-+-+-+ +-+ +-+ +-+ + +-+-+ +-+ + +-+
|         |     |   |   |       |   |   |
+-+-+-+-+-+-+-+-+-+-+ +-+-+-+-+-+-+-+-+-+